20
20
####################
######   ########  #
###### * ########  #
######   ########  #
################# M#
############       #
############       #
############       #
############       #
#################  #
#################  #
####     ########  #
####  P  ########  #
####     ###########
#################  #
#################  #
########  #######  #
########  #######  #
#################  #
####################