20
20
####################
######   ########  #
###### * ########  #
######   ######## S#
##B##############  #
############  N    #
############  H    #
############       #
########B###  H    #
##B##############  #
################B  #
####     ########  #
####  P  ########  #
####     ########  #
#################  #
#############B###  #
#################  #
#####*###########  #
#################  #
####################