20
20
####################
######   ########  #
###### * ########  #
######   ########  #
#################  #
############ N     #
#####  #####       #
#####  #####       #
############ H     #
#################  #
#################  #
####     ########  #
####  P  ########  #
####     ########  #
#################SH#
####################
#################  #
############**###  #
#################  #
####################