20
20
####################
######   ########  #
###### * ########   
######   ######## S 
##B##############   
############        
############  H    #
############       #
########B          #
##B#######          
############## #B   
####     ##### ##   
####  P  ##### ##   
####     ##### ##   
######    #### ##   
######### ###B  #   
######### ####      
#####*###           
############### #   
############### #   